NO ./north_texture.xpm
SO ./south_texture.xpm
WE ./west_texture.xpm
EA ./east_texture.xpm


C 225,30,0
F 220,100,0


        1111111111111111111111111
        1000000000000000111111001
        10000000000000001    1001
        100000000000N0001    1001
        10000000000000000    1001
        1000000000000000111111001
        1000000000000000000000001
        1111111111111111111111111
